..........................
..........................
..........................
..........................
..........###############.
..........................
..........................
##########################
..........................
..........................
....:::.......:::.........
....###.......###.........
..........................
.:................:.......
..........................
