..........................
..........................
..........................
..........................
..........................
..........................
..........................
..........................
..........................
..........................
....GGG.......GGG.........
....###.......###.........
..........................
.1................X.......
##########################
