.....................................................................................................
.....................................................................................................
.....................................................................................................
.....................................................................................................
..........................................................*..........................................
........................................................#####################........................
..............................................###########...#################........................
..........................................................@.#################........................
............................................................#################........................
..............................................###############################........................
...................................*..........###############################........................
......................@.......................####.......####################........................
...................1...........####...........................###############........................
.........................########...#........######...####....###############........................
................##################...####.....................###############........................
...........................###..........####..................###############........................
..................2...........................................###############........................
#######################........########.......##########..##..###############........................
####.....########.....######...##########.....#...............###############........................
####..*...######...........#####........##....#...............###############........................
####.....................................##.@.#...............###############........................
####......................................#####...............###############........................
####......................................%%%%%.....########..###############........................
####......................................%%%%%....##.........###############........................
#######################..###########################..........#############..........................
.....##...##.........................................................................................
.....#...............................................................................................
..............................................................#####################.&&&&&............
.....................................................................................................
.....................................................................................................
..............................................................###############........................
..............................................................###############........................
..............................................................###############........................
..............................................................###############........................
