...................................................................................................................................................................................................................
...................................................................................................................................................................................................................
...................................................................................................................................................................................................................
.................................................#.................................................................................................................................................................
.................................................#...*.............................................................................................................................................................
.................................................#.................................................................................................................................................................
.................................................##................................................................................................................................................................
.................................................##................................................................................................................................................................
.................................................###...............................................................................................................................................................
..................................................##...............................................................................................................................................................
...................................................#########.......................................................................................................................................................
...........................................................#####...................................................................................................................................................
...............................................................###.............................#########............................#######........................................................................
.................................................................##...........................##.......###............#####.......###########......................................................................
..................................................................###........................##..........#####....###########..#######..######.....................................................................
....................................................................##......................###.........................####.....#####%%########...................................................&...............
.....................................................................##########################.@..................................###.......#################################################....###..............
............................................................................................###....................................................................................................................
.............................................................................................##....................................................................................................................
..............................................................................................#############..#######...............................................................................................
...................................................................................................................###.............................................................................................
.....................................................................................................................###...........................................................................................
.......................................................................................................................##..........................................................................................
........................................................................................................................##......................@..................................................................
.........................................................................................................................##.................##.....................................................................
..........................................................................................................................####...####......####......####%%%%##....................................................
...............................................................................................................@....................##################.............................................................
.................1.............@..........................................................................................................#####....................................................................
....................................%%%%%.............#.....................................................................................##.....................................................................
....................................%%%%%...........####...................###...........####.......######........................................*................................................................
............................*****...%%%%%.......################....###########......#####..#######################################................................................................................
...............#####################################.....................######..####.......%%%%%%%%%%%%%%%%%%%%%%%%%%%%%%%........................................................................................
.................................................##.........................#######.........%%%%%%%%%%%%%%%%%%%%%%%%%%%%%%%........................................................................................
............................................................................................%..........*..................%........................................................................................
............................................................................................%%%%%%%%%%%%%%%%%%%%%%%%%%%%%%%........................................................................................
.................2..........................................................................%%%%%%%%%%%%%%%%%%%%%%%%%%%%%%%........................................................................................
...........................................................................................###########...###################.......................................................................................
...................................................................................................................................................................................................................
...................................................................................................................................................................................................................
...................................................................................................................................................................................................................
...................................................................................................................................................................................................................