...................................................................................................................................................................................................................
...................................................................................................................................................................................................................
...................................................................................................................................................................................................................
...................................................................................................................................................................................................................
.......................................................#...........................................................................................................................................................
.......................................................#...........................................................................................................................................................
.......................................................#...........................................................................................................................................................
.......................................................#.*.........................................................................................................................................................
.......................................................##..........................................................................................................................................................
........................................................###.*......................................................................................................................................................
..........................................................##......*................................................................................................................................................
...........................................................#####........................................................................*..........................................................................
...............................................................###.............................#########...........................................................................................................
.................................................................##......*....................##.......###........##########.......###########.....*.............*.................................................
..................................................................###*.......................##.....*....#####........########..###############....................................................................
.................................................................*..##......................###.........................####.....######.....####.........*.........................................&...............
.....................................................................#########################..................@..............................################################################...###..............
...................................................................................................................................................................................................................
.............................................................................................................#######...............................................................................................
...................................................................................................................###.............................................................................................
.....................................................................................................................###...........................................................................................
.......................................................................................................................##..........................................................................................
........................................................................................................................##...............................@.........................................................
.........................................................................................................................##........................................................................................
....................................***...................................................................................####...####......####......#########.....................................................
......................................................................................................@.............................##################.............................................................
........................................................................................................................................#####......................................................................
.................1.......**.....@.................####............................................######........................................*..................................................................
.....................***....***..............###############.....###########......#############################################....................................................................................
...............#####################################......................###########.......%%%%%%*%%%%%%%*%%%%%%%*%%%%%%%%........................................................................................
............................................................................#######.........%%%%%*%*%%%%%*%*%%%%%*%*%%%%%*%........................................................................................
.................2..........................................................................%%%%*%%%*%%%*%%%*%%%*%%%*%%%*%%........................................................................................
............................................................................................%*%*%%%%%*%*%%%%%*%*%%%%%*%*%%%........................................................................................
............................................................................................%%*%%%%%%%*%%%%%%%*%%%%%%%*%%%%........................................................................................
...........................................................................................###########...###################.......................................................................................
...................................................................................................................................................................................................................
...................................................................................................................................................................................................................
...................................................................................................................................................................................................................
...................................................................................................................................................................................................................