...................................................................................................................................................................................................................
...................................................................................................................................................................................................................
...................................................................................................................................................................................................................
...................................................................................................................................................................................................................
.......................................................#...........................................................................................................................................................
.......................................................#...........................................................................................................................................................
.......................................................#...........................................................................................................................................................
.......................................................#.*.........................................................................................................................................................
.......................................................##..........................................................................................................................................................
........................................................###........................................................................................................................................................
..........................................................##.......................................................................................................................................................
...........................................................#####...................................................................................................................................................
...............................................................###.............................#########...........................................................................................................
.................................................................##...........................##.......###.............#####.......###########.....................................................................
..................................................................###........................##..........#####.....###########..###############....................................................................
....................................................................##......................###.........................####.....######.....####...................................................................
.....................................................................#########################.................................................################################################...&................
................................................................................@..................................................................................................................................
.............................................................................................................#######...............................................................................................
...................................................................................................................###.............................................................................................
.....................................................................................................................###...........................................................................................
.......................................................................................................................##..........................................................................................
........................................................................................................................##...............................@.........................................................
.........................................................................................................................##........................................................................................
....................................***...................................................................................####...####......####......#########.....................................................
......................................................................................................@.............................##################.............................................................
.................1......................................................................................................................#####......................................................................
.........................**.....@.................####............................................######........................................*..................................................................
.....................***....***..............###############.....###########......#############################################....................................................................................
...............#####################################......................###########.......%%%%%%*%%%%%%%*%%%%%%%*%%%%%%%%........................................................................................
............................................................................#######.........%%%%%*%*%%%%%*%*%%%%%*%*%%%%%*%........................................................................................
............................................................................................%%%%*%%%*%%%*%%%*%%%*%%%*%%%*%%........................................................................................
............................................................................................%*%*%%%%%*%*%%%%%*%*%%%%%*%*%%%........................................................................................
.................2..........................................................................%%*%%%%%%%*%%%%%%%*%%%%%%%*%%%%........................................................................................
...........................................................................................###########...###################.......................................................................................
...................................................................................................................................................................................................................
...................................................................................................................................................................................................................
...................................................................................................................................................................................................................
...................................................................................................................................................................................................................