....................
....................
..........:.........
.......######.......
..:..............:..
####..:.:.:.:....###
.......:.:.:::......
......::::::::......
...::...........::..
....................
.:.:............:.:.
####............####
....................
.:..................
####################
