....................
...:............:...
...::..:.......::...
....:.::........#...
...##..........##...
...#......#....#....
...##....##....##...
....#...........#...
...::........:.##...
...#........::.#....
...##..........::...
....:...........:...
...##..........##...
.:..................
####################
